9,9,1,1,1,1,1,9
1,1,1,0,0,0,1,9
1,3,J,2,0,0,1,9
1,1,1,0,2,3,1,9
1,3,1,1,2,0,1,9
1,0,1,0,3,0,1,1
1,2,0,4,2,2,3,1
1,0,0,0,3,0,0,1
1,1,1,1,1,1,1,1