9,9,9,9,9,9,9,1,1,1,1,1,9
9,1,1,1,1,1,1,1,0,0,0,1,1
1,1,0,1,0,J,1,1,0,2,2,0,1
1,0,0,0,0,2,0,0,0,0,0,0,1
1,0,0,2,0,0,1,1,1,0,0,0,1
1,1,1,0,1,1,1,1,1,2,1,1,1
1,0,2,0,0,1,1,1,0,3,3,1,9
1,0,2,0,2,0,2,0,3,3,3,1,9
1,0,0,0,0,1,1,1,3,3,3,1,9
1,0,2,2,0,1,9,1,3,3,3,1,9
1,0,0,1,1,1,9,1,1,1,1,1,9
1,1,1,1,9,9,9,9,9,9,9,9,9